Command,Finished,Error,Burst Time in milliseconds,Turnaround Time in milliseconds,Waiting Time in milliseconds,Response Time in milliseconds
fsdgs,No,Yes,1,102,101,101
ls gewgwe,No,Yes,3,207,204,204
echo hello,Yes,No,1,208,207,207
cd ../,Yes,No,5,315,310,310
 ,Yes,No,12,327,315,315
pwd,Yes,No,1,328,327,327
echo Round Completed,Yes,No,1,330,329,329
./d.out,Yes,No,1900,8358,6458,208
./c.out,Yes,No,3817,9961,6144,102
./b.out,Yes,No,9637,15379,5742,0
