Command,Finished,Error,Burst Time in milliseconds,Turnaround Time in milliseconds,Waiting Time in milliseconds,Response Time in milliseconds
fsdfg,No,Yes,4,1009,1005,1005
ls,Yes,No,4,2017,2013,2013
echo hello,Yes,No,3,2021,2018,2018
echo world,Yes,No,7,3028,3021,3021
ls,Yes,No,5,3033,3028,3028
pwd,Yes,No,3,3037,3034,3034
sleep 1,Yes,No,1006,4039,3033,0
sleep 3,Yes,No,1004,4040,3036,1009
sleep 2,Yes,No,1002,5046,4044,3037
sleep 4,Yes,No,2988,6029,3041,2021
