Command,Finished,Error,Burst Time in milliseconds,Turnaround Time in milliseconds,Waiting Time in milliseconds,Response Time in milliseconds
fsdgs,No,Yes,1,106,105,105
ls gewgwe,No,Yes,3,213,210,210
cd ../,Yes,No,5,424,419,419
 ,Yes,No,11,435,424,424
pwd,Yes,No,2,437,435,435
echo Round Completed,Yes,No,1,438,437,437
./e.out,Yes,No,318,1661,1343,213
./d.out,Yes,No,1904,7588,5684,318
./c.out,Yes,No,3820,11199,7379,106
./b.out,Yes,No,9531,15596,6065,0
