Command,Finished,Error,Burst Time in milliseconds,Turnaround Time in milliseconds,Waiting Time in milliseconds,Response Time in milliseconds
fsdgs,No,Yes,1,106,105,105
ls gewgwe,No,Yes,2,211,209,209
echo hello,Yes,No,2,213,211,211
cd ../,Yes,No,6,322,316,316
 ,Yes,No,11,334,323,323
pwd,Yes,No,1,335,334,334
echo Round Completed,Yes,No,2,337,335,335
./d.out,Yes,No,1886,8261,6375,213
./c.out,Yes,No,3760,9905,6145,107
./b.out,Yes,No,9429,15102,5673,0
