Command,Finished,Error,Burst Time in milliseconds,Turnaround Time in milliseconds,Waiting Time in milliseconds,Response Time in milliseconds
fsdgs,No,Yes,1,506,505,505
ls gewgwe,No,Yes,2,1013,1011,1011
echo hello,Yes,No,1,1014,1013,1013
echo world,Yes,No,2,1518,1516,1516
 ,Yes,No,11,1529,1518,1518
pwd,Yes,No,1,1530,1529,1529
echo Round Completed,Yes,No,2,1532,1530,1530
./d.out,Yes,No,1891,8155,6264,1014
./c.out,Yes,No,3774,9812,6038,506
./b.out,Yes,No,9480,15166,5686,0
